SO ./textures/spid_noir.xpm
EA ./textures/eye_red.xpm
NO ./textures/spid_gris.xpm
WE ./textures/eye.xpm

F 80,80,80
C 163,206,220

 111
 1S1
11011111111111111111
11011000000000000001
11011000101111111001
11011111101000000101
11000000000000000101
10111111111000000101
1000000001100000011
1000110001000000011
111111111111111111
     
11111111111111111111
10001100011011111101
11111000000000000001
1  10000000000000001
11111111111111111111